#######
#PG...#
##....#
#B.B#.#
#....X#
#k...E#
#######