#######
#P#...#
#.....#
#.Bk..#
#.B...#
#E.G..#
#######