#######
#P...k#
#.B...#
#..#.B#
#.#...#
#G....#
#######