#######
#P...k#
#.....#
#.G#.B#
#.....#
#E.B..#
#######