#######
#P...##
##..#.#
#.Bk.X#
#.B...#
#..G.E#
#######