#######
#P....#
#.B...#
#.#...#
#.kB.##
#G....#
#######