#######
#P..#.#
#G..kB#
#B....#
#..#.##
##...E#
#######