#######
#Pk#..#
#B.#.G#
#.....#
#.B..##
#E#...#
#######