#######
#P....#
#G..kB#
#B#...#
#X....#
#E....#
#######