#######
#P....#
#B..G.#
##..B##
#.....#
#k....#
#######