#######
#P....#
##.#B.#
#.....#
#...kG#
#E..B##
#######