#######
#PBB..#
###..X#
#.....#
#..k#G#
#E...##
#######