#######
#PB.Bk#
#.....#
#....##
#.....#
#EG.X.#
#######