#######
#PB.Bk#
##..#.#
#.....#
##...##
#.GX.E#
#######