#######
#P...k#
##..X.#
#.G..B#
#.....#
##.B#E#
#######