#######
#P....#
#B..G##
#...B.#
#.....#
#k...E#
#######