#######
#P..#.#
#B..X.#
#...#.#
#.X.BG#
#.k..E#
#######