#######
#P....#
#B....#
#.....#
#...BG#
#Ek...#
#######