#######
#P..#.#
#....B#
#.B..##
#..k..#
#EG...#
#######