#######
#PB..G#
#.B..k#
#.#X#.#
#....X#
#E...X#
#######