#######
#P#..k#
#.B..##
#....B#
#.#.#.#
#G.#.E#
#######