#######
#PG...#
#.....#
#k....#
#....B#
#E.B..#
#######