#######
#P...##
#.....#
#.k#..#
#.BGB.#
#E....#
#######