#######
#P....#
#...B.#
##....#
#...Gk#
#..B.E#
#######