#######
#P..#.#
#.#..B#
#.B..##
#.#k..#
#.G..E#
#######