#######
#PB..G#
#.B..k#
#.#...#
#...#.#
#....E#
#######