#######
#P..#.#
#.....#
##Bk.##
#.GB..#
#E....#
#######