#######
#PG...#
#.....#
#B.B..#
#.#.###
#k....#
#######