#######
#P....#
##.#..#
#.Bk..#
#.GB..#
##.#.E#
#######