#######
#P#.#.#
#.....#
#.k#X.#
##BGB.#
#...#E#
#######