#######
#PX.#.#
#.#.B.#
#.....#
#...kG#
#...BE#
#######