#######
#P....#
#.B...#
#..#..#
#.kB..#
#G.X.E#
#######