#######
#P...X#
#...B.#
#.....#
#...Gk#
#E.B..#
#######