#######
#PG...#
#...#.#
#k....#
#....B#
###B.E#
#######