#########
#P....B.#
#.......#
#.....G.#
#...#.XB#
#.#...#k#
#.......#
#...B.#E#
#########