#########
#P.....k#
##....GX#
#X....X.#
#....X..#
#...BB..#
##.#....#
#..#B#.E#
#########