#########
#Pk.B#..#
#..X.#..#
#.B..#..#
#.#...X.#
#B.#....#
###.G..X#
#EX.#...#
#########