#########
#P.#...B#
#.X.#...#
#.X...XB#
#.....BG#
#.......#
#.k...X.#
#...#..E#
#########