#########
#P......#
#B......#
#..B....#
#...G.B##
#X.#....#
#.k.#.###
#E#.....#
#########