#########
#PB.....#
#.##....#
#..#.#..#
#..B.BG.#
#..#..k.#
#......X#
#...#..E#
#########