#########
#P.....##
#B....#.#
##.B.X#.#
#..#G.B.#
##.#..#.#
#.k.....#
#...#..E#
#########