#########
#P...G..#
#X...#.##
#BB....##
#k......#
#..##B..#
#....#..#
#......E#
#########