#########
#P..X#..#
#..X....#
#.#X...##
#.BG....#
##B...B.#
#k...X..#
##..X..E#
#########