#########
#P...#X.#
#.kB....#
#.......#
#..XB.B.#
#X......#
#......##
#EG.#..##
#########