#########
#P#.#...#
#.......#
#G....#.#
#..B....#
##.k.#.B#
#.B#....#
#EX..#..#
#########