#########
#P...X..#
#..#...##
##...#..#
#.k...###
#.BB#...#
#G#...X.#
#...XB.E#
#########