#########
#P....k##
#.......#
#.....BB#
#..##...#
##.#....#
#.#.B..X#
#E.G..#.#
#########