#########
#P...#k.#
#.......#
#.....BB#
#..#.#X.#
##......#
#...B#..#
#..G#..E#
#########