#########
#P......#
##......#
#.....#.#
#.kX#...#
#XBB..#.#
#G..#..##
#E..#B..#
#########