#########
#P...k..#
#....B..#
#......B#
#....#..#
#.#.....#
#B....X.#
#....G.E#
#########