#########
#P.k...##
#B......#
#....X..#
#B......#
#...G.X.#
###B....#
#E......#
#########