#########
#P......#
#.......#
#.......#
#.BG....#
#.B...B.#
#kX##.#.#
#E.#....#
#########