#########
#P....#.#
#.kB....#
#X#..#..#
#.#.B.B.#
#.......#
#..X..X.#
#.G#...E#
#########