#########
#PB.....#
#...B#B.#
#..#..X.#
#...#X..#
#.......#
#G......#
#k#....E#
#########