#########
#P.kG...#
#B.#.#..#
#...#...#
#....#..#
#.......#
#.....BB#
#E......#
#########