#########
#Pk.B...#
#.......#
##B.....#
#.....#.#
#B......#
#...G.X.#
#.....#E#
#########