#########
#P#..k..#
#....B..#
##.....B#
#.......#
#.......#
#B....#.#
#E.#.G..#
#########