#########
#P..k...#
#.GX.B..#
#.......#
#......##
#..#....#
#....#.B#
#E....B.#
#########