#########
#P..k.#.#
#XG.#BX.#
#.##...X#
#.#.....#
##.X....#
#...#..B#
#..X..BE#
#########