#########
#PB.....#
#.X#B.B##
#......##
#...X...#
#..#....#
#G......#
#k......#
#########