#########
#PXk....#
#B.....##
#.....#X#
#B....#.#
#..#G..##
#..B....#
#.#....E#
#########