#########
#P.kG...#
#B...X#.#
#......##
##......#
#X#.#...#
#.....BB#
#.....XE#
#########