#########
#P#...B.#
#.###...#
#.##.XG.#
#......B#
#....#.k#
#....##.#
#E#.B...#
#########