#########
#P.....B#
#.G.#...#
#.#.....#
#...#..##
#.#...X.#
#......B#
#E...kB.#
#########