#########
#P.....k#
#.....G.#
#...X...#
##......#
#...BB..#
#...#.X.#
#E..B#..#
#########