#########
#P...G..#
##......#
#BB#..#.#
#k.##...#
##...B..#
#...##..#
#E......#
#########