#########
#P..#...#
#.#....X#
#.#.#..##
##......#
#.#B...G#
#..XBk..#
#EB.....#
#########