#########
#P......#
#.......#
##.X....#
##.#.#..#
##.B#..G#
#..#Bk.X#
#.B....E#
#########