#########
#P.....B#
#XG.....#
##..#..##
#.......#
#.#.#...#
#......B#
#.#..kBE#
#########