#########
#P...B..#
##...#..#
#......##
#.....###
#...#kB.#
##G.X.#B#
#......E#
#########