#########
#P.X.B..#
#......##
#.....#.#
#..#...##
#..#.kB.#
#.G....B#
#E..XX..#
#########