#########
#P......#
#....#.##
#G......#
#..B#...#
#..k...B#
#.B#....#
#......E#
#########