#########
#PB.....#
#.X...###
#.......#
#..B.BG.#
#.....k.#
#.##..#.#
#E...#..#
#########