#########
#P.#X..B#
#.......#
#..X.X.B#
#.....BG#
#....#..#
#.k#..#.#
#E...#..#
#########